XXXXXXXXX
X--X-G--X
X--X--X-X
X-TX--X-X
X-----X-X
X-P---X-X
XXXXXXXXX